{
    "name": "Expert Map",
    "mapData": {
      "grid": [
        [1, 4, 1, 1, 4, 0, 4, 1, 0, 0],
        [0, 2, 4, 4, 2, 1, 1, 0, 0, 0],
        [3, 3, 0, 2, 4, 4, 4, 4, 0, 0],
        [4, 1, 4, 3, 1, 0, 1, 1, 0, 0],
        [4, 1, 4, 3, 1, 0, 1, 4, 0, 0],
        [3, 0, 4, 3, 1, 1, 1, 4, 0, 0],
        [0, 1, 4, 3, 0, 1, 1, 0, 0, 0],
        [0, 1, 4, 3, 0, 1, 0, 1, 1, 0],
        [4, 1, 4, 3, 0, 1, 0, 0, 0, 0],
        [0, 4, 4, 3, 1, 1, 1, 1, 0, 0],
        [0, 1, 4, 3, 0, 0, 0, 1, 0, 1],
        [0, 0, 0, 0, 0, 0, 0, 0, 0, 0]
      ],
      "start": [0, 0],
      "goal": [11, 9],
      "legend": {
        "0": "empty",
        "1": "wall",
        "2": "water",
        "3": "rock",
        "4": "forest"
      },
      "costs": {
        "empty": 1,
        "wall": -1,
        "water": 5,
        "rock": 3,
        "forest": 10
      }
    }
  }
  